[BEH]
ad	adware
adagent	adware
adbundle	adware
adbundler	adware
addisplay	adware
addrop	adware
addropgen	adware
adawre	adware
addware	adware
adinject	adware
adinstaller	adware
adspy	adware
adtool	adware
adw	adware
adwar	adware
adware2	adware
adware5	adware
adwarea	adware
adwareagent	adware
adwareare	adware
adwaredropper	adware
adwarep	adware
adwaret	adware
adwarex	adware
adwre	adware
aware	adware
hfsadware	adware
av	antiav
antiavp	antiav
antiavt	antiav
antiavg	antiav
antiavs	antiav
killav	antiav
killav2	antiav
killav3	antiav
killav4	antiav
killav5	antiav
killav7	antiav
killav9	antiav
killava	antiav
killavb	antiav
killavf	antiav
killavk	antiav
killavl	antiav
killavp	antiav
killavs	antiav
killavt	antiav
killavx	antiav
killavat	antiav
anti	antifw
anti2	antifw
antifwk	antifw
autorun2	autorun
autorun4	autorun
autorun54	autorun
autorun56	autorun
autorun6	autorun
autoruna	autorun
autoruner	autorun
autorunf	autorun
autorung	autorun
autorunh	autorun
autoruni	autorun
autorunk	autorun
autorunl	autorun
autorunn	autorun
autorunp	autorun
autorunq	autorun
autorunr	autorun
autorunt	autorun
autorunu	autorun
autorunw	autorun
autoruny	autorun
autorunerent	autorun
autoruninf	autorun
autoruns	autorun
otorung	autorun
otorun	autorun
otorun1	autorun
otorun2	autorun
otorun3	autorun
otorun4	autorun
otorun5	autorun
otorun7	autorun
otorun8	autorun
otorun9	autorun
otoruna	autorun
otorune	autorun
otorunk	autorun
otorunn	autorun
otoruno	autorun
otorunp	autorun
otorunq	autorun
ackdoor	backdoor
bkdr64	backdoor
bacdkoor	backdoor
backdoo	backdoor
backdooe	backdoor
backdooor	backdoor
backdoor1	backdoor
backdoor10	backdoor
backdoor14	backdoor
backdoor2	backdoor
backdoor3	backdoor
backdoor4	backdoor
backdoor5	backdoor
backdoora	backdoor
backdoorapt	backdoor
backdoord	backdoor
backdoorg	backdoor
backdoorhaxdoor	backdoor
backdoorj	backdoor
backdoorl	backdoor
backdoorm	backdoor
backdoormsil	backdoor
backdoorp	backdoor
backdoorq	backdoor
backdoors	backdoor
backdoort	backdoor
backdooru	backdoor
backdoorv	backdoor
backdoorw	backdoor
backdoorwin32	backdoor
backdoorx	backdoor
backdoory	backdoor
backdoorz	backdoor
backdoot	backdoor
backdor	backdoor
backldoor	backdoor
bck	backdoor
bckdr	backdoor
bdoor	backdoor
bdoor4	backdoor
bkdr	backdoor
badjoker	badjoke
bank	banker
banker1	banker
banker10	banker
banker11	banker
banker12	banker
banker13	banker
banker14	banker
banker15	banker
banker16	banker
banker17	banker
banker2	banker
banker3	banker
banker4	banker
banker5	banker
banker6	banker
banker7	banker
banker8	banker
banker9	banker
bankerb	banker
bankerd	banker
bankere	banker
bankerf	banker
bankerh	banker
bankerp	banker
bankers	banker
bankert	banker
bankeru	banker
bankerx	banker
trojanbanker	banker
trjanbanker	banker
vbanker	banker
binder2	binder
binderc	binder
boo	bootkit
bookit	bootkit
boot1	bootkit
boot2	bootkit
botnet	bot
brmodifier	browsermodifier
broswermodifier	browsermodifier
bundl	bundler
bundlerx	bundler
genbundler	bundler
softwarebundler	bundler
eject	cdeject
adclicks	clicker
adlickr	clicker
adclick	clicker
adclickerscript	clicker
agentclick	clicker
click1	clicker
click14	clicker
click2	clicker
click23	clicker
click3	clicker
click	clicker
clickerk	clicker
adclicer	clicker
adclickr	clicker
adclicke	clicker
adclicker	clicker
adclickera	clicker
adclickeri	clicker
adclickert	clicker
adclickn	clicker
adclickr	clicker
adclckr	clicker
clicker1	clicker
clicker2	clicker
clicker95	clicker
clickera	clicker
clickerl	clicker
clickern	clicker
clickerp	clicker
clickert	clicker
clickeru	clicker
clickerw	clicker
clickjack	clicker
htmlclicker	clicker
rojanclicker	clicker
tjnclicker	clicker
trojanclicker	clicker
bitcoinminer	coinminer
bitcoinminerc	coinminer
bitcoinminerf	coinminer
bitcoinminerj	coinminer
bitcoinminerk	coinminer
bitcoinminerl	coinminer
bitcoinminern	coinminer
bitcoinminerp	coinminer
bitminer	coinminer
bitminera	coinminer
btcmine	coinminer
btcminer	coinminer
coinmer	coinminer
coinminera	coinminer
coinminerk	coinminer
coinminerp	coinminer
coinminerq	coinminer
coinminerx	coinminer
cryptominer	coinminer
jswebcoin	coinminer
crypto	coinminer
miner	coinminer
miner2	coinminer
miner3	coinminer
miners	coinminer
constructorkit	constructor
constuctor	constructor
consturctor	constructor
contrustor	constructor
costructor	constructor
corrupt3	corrupt
corrupt4	corrupt
corruptfile	corrupt
corrupto	corrupt
crack	cracktool
cryp	cryptor
crpytor	cryptor
crypt	cryptor
cryptz	cryptor
crypt1	cryptor
crypt12	cryptor
crypt2	cryptor
crypt3	cryptor
crypt4	cryptor
crypt49	cryptor
crypt5	cryptor
crypt6	cryptor
crypt7	cryptor
crypt8	cryptor
crypt9	cryptor
cryptom	cryptor
cryptop	cryptor
cryptos	cryptor
cryptow	cryptor
krypt12	cryptor
cryptov	cryptor
cryptool	cryptor
crypticb	cryptor
cryptorv	cryptor
cryptoz	cryptor
polycryptor	cryptor
ddoser	ddos
ddoserb	ddos
ddosstf	ddos
ddostool	ddos
demo1	demo
demo10	demo
demo16	demo
adialer	dialer
dailer	dialer
dbedialers	dialer
dial	dialer
dial30	dialer
dialerb	dialer
dialerd	dialer
dialere	dialer
dialerg	dialer
dialerq	dialer
dialers	dialer
dialert	dialer
dialeru	dialer
dialerv	dialer
dialerx	dialer
dialerz	dialer
dialler	dialer
genericdialer	dialer
porndialer	dialer
porndialers	dialer
ddlr	downloader
dlagent	downloader
dldr	downloader
dldr0	downloader
dldr2	downloader
dldr20	downloader
dldr21	downloader
dldr22	downloader
dldr23	downloader
dldr27	downloader
dldr29	downloader
dldr3	downloader
dldr32	downloader
dldr36	downloader
dldr37	downloader
dldr5	downloader
dl	downloader
dldr	downloader
dloader	downloader
dloaderd	downloader
dloadr	downloader
dloadre	downloader
dloadware	downloader
doawnloader	downloader
downdloader	downloader
downloaderagent	downloader
downloaderb	downloader
downloaderk	downloader
downlader	downloader
downldr	downloader
downldr1	downloader
downldr2	downloader
downldr3	downloader
downldro	downloader
downldrp	downloader
downldrx	downloader
download	downloader
download1	downloader
download11	downloader
download2	downloader
download3	downloader
download4	downloader
downloade	downloader
downloadeer	downloader
downloader1	downloader
downloader10	downloader
downloader11	downloader
downloader12	downloader
downloader13	downloader
downloader14	downloader
downloader15	downloader
downloader16	downloader
downloader17	downloader
downloader18	downloader
downloader19	downloader
downloader2	downloader
downloader20	downloader
downloader21	downloader
downloader22	downloader
downloader23	downloader
downloader24	downloader
downloader25	downloader
downloader26	downloader
downloader27	downloader
downloader28	downloader
downloader29	downloader
downloader3	downloader
downloader30	downloader
downloader31	downloader
downloader32	downloader
downloader33	downloader
downloader34	downloader
downloader35	downloader
downloader36	downloader
downloader37	downloader
downloader38	downloader
downloader39	downloader
downloader4	downloader
downloader40	downloader
downloader41	downloader
downloader42	downloader
downloader43	downloader
downloader44	downloader
downloader45	downloader
downloader5	downloader
downloader6	downloader
downloader7	downloader
downloader8	downloader
downloader9	downloader
downloadera	downloader
downloaderagentb	downloader
downloaderc	downloader
downloadere	downloader
downloaderf	downloader
downloaderg	downloader
downloaderi	downloader
downloaderj	downloader
downloaderp	downloader
downloaderr	downloader
downloaders	downloader
downloadert	downloader
downloaderv	downloader
downloaderx	downloader
downloadf	downloader
downloadl	downloader
downloadp	downloader
downloadr	downloader
downloadt	downloader
downloady	downloader
downloaler	downloader
downlodaer	downloader
dwn	downloader
dwnldr	downloader
dowloader	downloader
downagent	downloader
downlaoder	downloader
downldexe	downloader
downloadagentae	downloader
downloaderai	downloader
doanloaderch	downloader
downloadergd	downloader
downloadervb	downloader
downloads	downloader
downware	downloader
trjndwnlder	downloader
elfdownloader	downloader
gendownloader	downloader
ofdownloader	downloader
troajndownloader	downloader
trojandownloader	downloader
trojdownloader	downloader
trojdwnloader	downloader
ttojandownloader	downloader
downloaderagent2	downloader
trojandownload	downloader
downware2	downloader
downware3	downloader
downwareg	downloader
dldragent	downloader
dldrx	downloader
drp	dropper
muldrop1	dropper
muldrop10	dropper
muldrop11	dropper
muldrop12	dropper
muldrop13	dropper
muldrop14	dropper
muldrop15	dropper
muldrop16	dropper
muldrop17	dropper
muldrop18	dropper
muldrop19	dropper
muldrop2	dropper
muldrop20	dropper
muldrop21	dropper
muldrop3	dropper
muldrop4	dropper
muldrop5	dropper
muldrop6	dropper
muldrop7	dropper
muldrop8	dropper
muldrop9	dropper
muldropa	dropper
dr	dropper
droopper	dropper
droper	dropper
dropoper	dropper
dropper0	dropper
dropper2	dropper
dropper5	dropper
dropper6	dropper
dropper7	dropper
dropper8	dropper
dropperagent	dropper
dropperagenta	dropper
dropperagentc	dropper
dropperagentf	dropper
dropperagento	dropper
dropperagentr	dropper
dropperc	dropper
dropperl	dropper
droppero	dropper
dropperp	dropper
droppert	dropper
dropperv	dropper
droppery	dropper
droppger	dropper
genericdropper	dropper
multidropper	dropper
scriptdroppere	dropper
tjndroppr	dropper
trdropper	dropper
trjndropper	dropper
trojandropper	dropper
trojandroppe	dropper
dropperx	dropper
muldrop	dropper
encoderxor	encoder
expkit	exploitkit
expkit3	exploitkit
expkit5	expkit
exp	exploit
expl	exploit
expl3it	exploit
expl4it	exploit
exploit1	exploit
exploit2	exploit
exploitkit1	exploit
exploitr	exploit
exploits	exploit
exploitt	exploit
exploitx	exploit
explort	exploit
explot	exploit
rtfexploit	exploit
fakealert1	fakealert
fakealert10	fakealert
fakealert12	fakealert
fakealertd	fakealert
fakealertn	fakealert
fakealertq	fakealert
fakealertt	fakealert
fakealertw	fakealert
fakealertx	fakealert
fakealerty	fakealert
fakealertv	fakealert
fakeavcx	fakeantivirus
fakeavdl	fakeantivirus
fakeantivirus	fakeantivirus
fakeantivirus8	fakeantivirus
fakeantivirusn	fakeantivirus
fakeav	fakeantivirus
fakeav08	fakeantivirus
fakeav09	fakeantivirus
fakeav1	fakeantivirus
fakeav10	fakeantivirus
fakeav11	fakeantivirus
fakeav12	fakeantivirus
fakeav13	fakeantivirus
fakeav14	fakeantivirus
fakeav15	fakeantivirus
fakeav16	fakeantivirus
fakeav17	fakeantivirus
fakeav18	fakeantivirus
fakeav19	fakeantivirus
fakeav2	fakeantivirus
fakeav20	fakeantivirus
fakeav21	fakeantivirus
fakeav22	fakeantivirus
fakeav23	fakeantivirus
fakeav24	fakeantivirus
fakeav25	fakeantivirus
fakeav26	fakeantivirus
fakeav27	fakeantivirus
fakeav28	fakeantivirus
fakeav29	fakeantivirus
fakeav3	fakeantivirus
fakeav30	fakeantivirus
fakeav31	fakeantivirus
fakeav32	fakeantivirus
fakeav33	fakeantivirus
fakeav34	fakeantivirus
fakeav35	fakeantivirus
fakeav36	fakeantivirus
fakeav37	fakeantivirus
fakeav38	fakeantivirus
fakeav39	fakeantivirus
fakeav4	fakeantivirus
fakeav40	fakeantivirus
fakeav41	fakeantivirus
fakeav42	fakeantivirus
fakeav43	fakeantivirus
fakeav44	fakeantivirus
fakeav45	fakeantivirus
fakeav46	fakeantivirus
fakeav47	fakeantivirus
fakeav48	fakeantivirus
fakeav49	fakeantivirus
fakeav5	fakeantivirus
fakeav50	fakeantivirus
fakeav51	fakeantivirus
fakeav52	fakeantivirus
fakeav53	fakeantivirus
fakeav54	fakeantivirus
fakeav55	fakeantivirus
fakeav56	fakeantivirus
fakeav57	fakeantivirus
fakeav59	fakeantivirus
fakeav6	fakeantivirus
fakeav61	fakeantivirus
fakeav62	fakeantivirus
fakeav63	fakeantivirus
fakeav64	fakeantivirus
fakeav65	fakeantivirus
fakeav66	fakeantivirus
fakeav67	fakeantivirus
fakeav68	fakeantivirus
fakeav69	fakeantivirus
fakeav7	fakeantivirus
fakeav70	fakeantivirus
fakeav71	fakeantivirus
fakeav72	fakeantivirus
fakeav73	fakeantivirus
fakeav74	fakeantivirus
fakeav8	fakeantivirus
fakeav9	fakeantivirus
fakeava	fakeantivirus
fakeavb	fakeantivirus
fakeavc	fakeantivirus
fakeavd	fakeantivirus
fakeave	fakeantivirus
fakeavf	fakeantivirus
fakeavg	fakeantivirus
fakeavh	fakeantivirus
fakeavj	fakeantivirus
fakeavl	fakeantivirus
fakeavm	fakeantivirus
fakeavn	fakeantivirus
fakeavo	fakeantivirus
fakeavq	fakeantivirus
fakeavqkm	fakeantivirus
fakeavr	fakeantivirus
fakeavs	fakeantivirus
fakeavt	fakeantivirus
fakeavu	fakeantivirus
fakeavx	fakeantivirus
fakeavjs	fakeantivirus
fakecon1	fakecon
fakecon2	fakecon
fakecon3	fakecon
fakedocd	fakedoc
fakedoce	fakedoc
fileinfectora	fileinfector
fileinfectorb	fileinfector
fileinfectorc	fileinfector
fileinfectord	fileinfector
flooder2	flooder
flooderagent	flooder
flooderdelf	flooder
floodericqbomber	flooder
flooderl	flooder
flooderroomdestroyer	flooder
floodervb	flooder
fraud0	fraud
fraud1	fraud
fraud7	fraud
fraudload	fraud
fraudloada	fraud
fraudloadb	fraud
fraudloadc	fraud
fraudloadg	fraud
fraudloadh	fraud
fraudloadk	fraud
fraudloadl	fraud
fraudloadn	fraud
fraudloadt	fraud
fraudtool	fraud
fraudtoold	fraud
fraudtoolz	fraud
ftpget	ftp
serverftp	ftp
game2	game
game23	game
gamethief1	gamethief
gamethiefa	gamethief
gamethiefd	gamethief
gamethiefo	gamethief
gamethieft	gamethief
gamethiefx	gamethief
tjngmethief	gamethief
hack	hacktool
hack11	hacktool
hack7	hacktool
hack99	hacktool
hacktoolj	hacktool
bhacktool	hacktool
hacktoolx	hacktool
hackingtool	hacktool
hacktol	hacktool
hacktoola	hacktool
hacktoolhacktool	hacktool
hacktools	hacktool
hacktoolv	hacktool
hktl	hacktool
htool	hacktool
hiddenlink	hidelink
hidelinkk	hidelink
hijacker2	hijacker
smshoax	hoax
horse	trojan
horse1	trojan
horse2	trojan
horse3	trojan
horse4	trojan
hotbar2	hotbar
hotbar5	hotbar
hotbar6	hotbar
hotbare	hotbar
hotbarr	hotbar
hfsiframescript	iframe
iframe6	iframe
iframea	iframe
iframeb	iframe
iframebo	iframe
iframebof	iframe
iframebw	iframe
iframed	iframe
iframef	iframe
iframeinject	iframe
iframem	iframe
iframen	iframe
iframer	iframe
iframere	iframe
iframeref	iframe
iframeref1	iframe
iframeref2	iframe
iframeref3	iframe
iframeref4	iframe
iframeref5	iframe
iframeref6	iframe
iframeref7	iframe
iframeref8	iframe
iframeref9	iframe
iframes	iframe
iframev	iframe
iframey	iframe
infect	infector
infect2	infector
infector19	infector
infector20	infector
infectr	infector
infecto	infector
infector13	infector
infector18	infector
delfinjectb	injector
delfinjectf	injector
delfinjecth	injector
delfinjectl	injector
delfinjectt	injector
delfinjectu	injector
delfinjectw	injector
delfinjecty	injector
inject	injector
inject1	injector
inject2	injector
inject3	injector
inject4	injector
inject64	injector
injecter	injector
injectq	injector
injectr	injector
injects	injector
injectt	injector
vbinjectb	injector
injecte	injector
infectorr	injector
infectorx	injector
injecta	injector
injecth	injector
injectk	injector
injecto	injector
injector1	injector
injector10	injector
injector2	injector
injector3	injector
injector4	injector
injector5	injector
injector6	injector
injector7	injector
injector8	injector
injector9	injector
injectora	injector
injectorb	injector
injectorc	injector
injectord	injector
injectore	injector
injectorf	injector
injectorg	injector
injectori	injector
injectork	injector
injectorn	injector
injectort	injector
injectoru	injector
injectorw	injector
injectorx	injector
injectory	injector
injectorz	injector
clientirc	ircbot
irc	ircbot
mirc	ircbot
ircbotha	ircbot
ircbottn	ircbot
ircbottq	ircbot
ircprogram	ircbot
installm	installer
instally	installer
installad	installer
adinstall	installer
adinstaller	installer
bundleinstaller	installer
install	installer
pupinstaller	installer
toolbarinstaller	installer
installapp	installer
installc	installer
appinstall	installer
ircbot1	ircbot
ircbot2	ircbot
ircbot3	ircbot
ircbot4	ircbot
ircbota	ircbot
ircbotb	ircbot
ircbotc	ircbot
ircbotd	ircbot
ircbotg	ircbot
ircboth	ircbot
ircboth1	ircbot
ircboti	ircbot
ircbotk	ircbot
ircbotn	ircbot
ircboto	ircbot
ircbotp	ircbot
ircbots	ircbot
ircbott	ircbot
ircbottm	ircbot
ircbotto	ircbot
ircbottt	ircbot
ircbotu	ircbot
ircbotv	ircbot
ircbotx	ircbot
ircboty	ircbot
ircbotz	ircbot
badjoke	joke
badjokeb	joke
jokeapp	joke
jokeprogram	joke
joketool	joke
keylog	keylogger
keylog2	keylogger
keylog32	keylogger
keylog95	keylogger
keyloga	keylogger
keylogs	keylogger
keylogap	keylogger
keylogaz	keylogger
keylogg	keylogger
keyloggera	keylogger
keyloggere	keylogger
keyloggerg	keylogger
keyloggerh	keylogger
keyloggerj	keylogger
keyloggero	keylogger
keyloggers	keylogger
keyloggerw	keylogger
keylogm	keylogger
keylogo	keylogger
killproc2	killproc
lockscreenb	lockscreen
mail	mailer
massmailer	mailer
mailfindera	mailfinder
monitoring	monitoringtool
nuke	nuker
malpacked	packed
malpacked2	packed
malpacked3	packed
malpacked4	packed
malpacked5	packed
malpacked6	packed
malpacked7	packed
montool	monitoringtool
network1	network
maliciouspacker	packed
malpacked	packed
multipacked	packed
pack	packed
packed2	packed
packed3	packed
packer	packed
packer2	packed
packer3	packed
packert	packed
pepack	packed
patchedy	patcher
patcher2	patcher
patcherd	patcher
patcherx	patcher
pepatch	patcher
patch	patcher
abphisher	phishing
fishing	phishing
phish	phishing
phish1	phishing
phishing11	phishing
phishing12	phishing
phishing13	phishing
phishing14	phishing
phishing15	phishing
phishing16	phishing
phishing17	phishing
phishing18	phishing
phishing19	phishing
phishingx	phishing
trojanpos	pos
proxy2	proxy
proxy3	proxy
torjanproxy	proxy
trjnproxy	proxy
trojanproxy	proxy
psw	passwordstealer
pws	passwordstealer
pwstool	passwordstealer
pswtroj	passwordstealer
pwstrojan	passwordstealer
pwtool	passwordstealer
pswtool	passwordstealer
pwsteal	passwordstealer
passwords	passwordstealer
passwordstealera	passwordstealer
passwordstealerd	passwordstealer
passwordstealerw	passwordstealer
pwstealer	passwordstealer
pwstealer1	passwordstealer
pwstealer2	passwordstealer
pwstealer3	passwordstealer
pwstealerx	passwordstealer
password	passwordstealer
trojanpsw	passwordstealer
trojanpws	passwordstealer
porntool	porn
potentiallyunwanted	pua
puaadvertising	pua
puabundler	pua
puadlmanager	pua
unwanted	pua
uws	pua
garyware	pua
grayware	pua
encodedransom	ransom
raas	ransom
ranosm	ransom
ransom32	ransom
ransom64	ransom
ransoma	ransom
ransomare	ransom
ransomb	ransom
ransome	ransom
ransommsil	ransom
ransoms	ransom
ransomw	ransom
ransomware	ransom
ransomx	ransom
rasnom	ransom
ransomeware	ransom
ransomheur	ransom
tjnransom	ransom
trojanransom	ransom
ransomer	ransom
filcoder	ransom
filecoder	ransom
filecrypt	ransom
filecryptor	ransom
remoteaccesstool	rat
remoteadmin	rat
remadm	rat
redir	redirector
redir1	redirector
redir5	redirector
jsredir	redirector
redirect	redirector
redirect5	redirector
redirection	redirector
redirecto	redirector
redirectorr	redirector
redirectors	redirector
redirectr	redirector
redirects	redirector
refresh2	refresh
remotetool	remoteaccess
rishware	riskware
risk	riskware
risktool	riskware
securityrisk	riskware
rogues	rogue
rougue	rogue
rogueantispyware	rogue
rogueware	rogue
rkit	rootkit
ntrootkit	rootkit
ntrootkitt	rootkit
rootkit10	rootkit
rootkit2	rootkit
rootkit40	rootkit
rootkit5	rootkit
rootkita	rootkit
rootkitc	rootkit
rootkitd	rootkit
rootkitf	rootkit
rootkitq	rootkit
rootkits	rootkit
rootkitt	rootkit
rootkitx	rootkit
rootkitz	rootkit
rtk	rootkit
rtkt	rootkit
search3	searcher
search42	searcher
seo	seohide
server0	server
server1	server
server12	server
server2	server
server22	server
serverx	server
servstart2	servstart
servstarta	servstart
servstartd	servstart
servstartf	servstart
servstartg	servstart
servstarth	servstart
servstarti	servstart
servstartj	servstart
servstartl	servstart
servstartn	servstart
servstartr	servstart
servstarts	servstart
servstartt	servstart
servstartv	servstart
servstartw	servstart
servstartz	servstart
smscore	sms
smsplac	sms
clientsmtp	smtp
sniff	sniffer
sniffer1	sniffer
sftwrbndlr	softwarebundler
sftwrebndlr	softwarebundler
softwarebndlr	softwarebundler
softwarebundlr	softwarebundler
softwarebunlder	softwarebundler
softwbndlr	softwarebundler
swbundlr	softwarebundler
spam1	spam
spam6	spam
spammer	spam
spamtool	spam
spy	spyware
spy005568	spyware
spy009152	spyware
spy014784	spyware
spy020416	spyware
spy028096	spyware
spy031699	spyware
spy039360	spyware
spy039852	spyware
spy064960	spyware
spy07008	spyware
spy072128	spyware
spy073152	spyware
spy078784	spyware
spy08032	spyware
spy084928	spyware
spy085440	spyware
spy09056	spyware
spy101488	spyware
spy112576	spyware
spy114112	spyware
spy122304	spyware
spy134592	spyware
spy135952	spyware
spy138688	spyware
spy144352	spyware
spy14688	spyware
spy146880	spyware
spy151152	spyware
spy15200	spyware
spy155072	spyware
spy155584	spyware
spy16736	spyware
spy17248	spyware
spy179648	spyware
spy181184	spyware
spy18272	spyware
spy183744	spyware
spy18784	spyware
spy191936	spyware
spy19277	spyware
spy195520	spyware
spy196032	spyware
spy204717	spyware
spy204736	spyware
spy20832	spyware
spy208320	spyware
spy212416	spyware
spy216512	spyware
spy21856	spyware
spy223688	spyware
spy22880	spyware
spy23872	spyware
spy245184	spyware
spy25952	spyware
spy261568	spyware
spy26976	spyware
spy269760	spyware
spy283584	spyware
spy290240	spyware
spy294336	spyware
spy295360	spyware
spy30048	spyware
spy30560	spyware
spy306624	spyware
spy308160	spyware
spy311744	spyware
spy317888	spyware
spy323008	spyware
spy327488	spyware
spy343488	spyware
spy347584	spyware
spy350656	spyware
spy351680	spyware
spy363968	spyware
spy364488	spyware
spy376256	spyware
spy38240	spyware
spy384448	spyware
spy38752	spyware
spy390080	spyware
spy40800	spyware
spy41312	spyware
spy41336	spyware
spy425408	spyware
spy433088	spyware
spy4336	spyware
spy43360	spyware
spy437696	spyware
spy442816	spyware
spy44760	spyware
spy462272	spyware
spy472000	spyware
spy47968	spyware
spy482752	spyware
spy48480	spyware
spy49504	spyware
spy497600	spyware
spy51552	spyware
spy521152	spyware
spy533952	spyware
spy54393	spyware
spy552384	spyware
spy55648	spyware
spy57048	spyware
spy58208	spyware
spy5872	spyware
spy589760	spyware
spy6351	spyware
spy65280	spyware
spy65824	spyware
spy66400	spyware
spy67936	spyware
spy6896	spyware
spy69984	spyware
spy705984	spyware
spy727343	spyware
spy74592	spyware
spy75104	spyware
spy75616	spyware
spy76621	spyware
spy78176	spyware
spy80224	spyware
spy80717	spyware
spy82768	spyware
spy831127	spyware
spy83600	spyware
spy84320	spyware
spy85344	spyware
spy865728	spyware
spy86880	spyware
spy87904	spyware
spy880064	spyware
spy88416	spyware
spy8928	spyware
spy8944	spyware
spy93024	spyware
spy95584	spyware
spy96608	spyware
spy96636	spyware
spy97632	spyware
spyagent	spyware
spyare	spyware
spywaret	spyware
spywarex	spyware
sypyware	spyware
trojanspy	spyware
tspy	spyware
tspy64	spyware
startpage0	startpage
startpage1	startpage
startpage2	startpage
startpage3	startpage
startpage4	startpage
startpage5	startpage
startpage6	startpage
startpagea	startpage
startpaged	startpage
startpagef	startpage
startpagei	startpage
startpagel	startpage
startpagem	startpage
startpageq	startpage
startpager	startpage
startpages	startpage
startpaget	startpage
startpageu	startpage
startpagex	startpage
startpagey	startpage
coinstealer	stealer
infosteal	stealer
infostealer	stealer
infostealer2	stealer
infostealera	stealer
infostealerf	stealer
infostealern	stealer
infostealerq	stealer
infostealerz	stealer
stealera	stealer
stealers	stealer
stealerx	stealer
virtools	virtool
virtoolx	virtool
toolbaro	toolbar
toolbarx	toolbar
toolbat	toolbar
toolbars	toolbwar
multitoolbwar	toolbar
tr	trojan
trj	trojan
trjoan	trojan
troj	trojan
roj64	trojan
troja	trojan
trojaapt	trojan
trojain	trojan
trojan2	trojan
trojan3	trojan
trojan4	trojan
trojan5	trojan
trojanapt	trojan
trojanx	trojan
trojware	trojan
gentroj	trojan
smalltroj	trojan
trojan1	trojan
vbinj	vbinject
vbinj1	vbinject
vbinjecta	vbinject
vbinjectc	vbinject
vbinjectd	vbinject
vbinjectg	vbinject
vbinjectm	vbinject
vbinjectp	vbinject
vbinjectt	vbinject
virtl	virtool
virtoot	virtool
vtool	virtool
fileinfector	virus
oldvirus	virus
virus0	virus
virus02	virus
virus04	virus
virus05	virus
virus06	virus
virus2	virus
virus7	virus
virus9	virus
virus90	virus
virusorg	virus
fileinfectorx	virus
emailworm	worm
imworm	worm
networm	worm
networma	worm
networmb	worm
p2pworm	worm
scriptworm	worm
worm07	worm
worm1	worm
worm2	worm
worm3	worm
worm32	worm
worm4	worm
worm5	worm
worm6	worm
worm60	worm
worm64	worm
worm98	worm
wormapt	worm
wormbat	worm
wormdos	worm
wormspy	worm
wormsuljsuljsuljs	worm
wormwinnt	worm
worw	worm
wrm	worm
wrom	worm
vbsworm	worm
wormvbs	worm

[FILE]
am97	a97m
adnroidos	android
andr	android
andrgedma	android
androido	android
androidos	android
androidos2	android
androidosl	android
autoitu	autoit
acad	autolisp
alisp	autolisp
delphi5	delphi
delphi7	delphi
docdown	doc
embeddedjsinocxinworddoc	doc
sharedofficedocuments	doc
behaveslikedos	dos
dos32	dos
trojandos	dos
aself	elf
e32	elf
elf32	elf
elf64	elf
elfarm32	elf
elfarm64	elf
hllo1	hllo
hllo2	hllo
hllp	hllo
hllw	hllo
hmtl	html
htm	html
html5	html
htmlhelpcontrol	html
inno	innosetup
obfusjava	java
jpeg	jpg
javascript	js
jsagent	js
jscript	js
jsenc	js
linux64	linux
genautorunlnkfile	lnk
lnkdown	lnk
winlnk	lnk
mac	macos
osx	macos
osx32	macos
asmacro	macro
macro01	macro
macro40	macro
macrodown	macro
xlsmacro	macro
wm	macroword
xm	macroexcel
msil10	msil
msil2	msil
msil3	msil
msil4	msil
msil5	msil
msil6	msil
msil7	msil
msil8	msil
msil9	msil
msilkrypt	msil
msilkrypt02	msil
msilkrypt03	msil
msilkrypt04	msil
msilkrypt05	msil
msilkrypt08	msil
msilkrypt09	msil
msilkrypt10	msil
msilkrypt11	msil
msilkrypt12	msil
msilkrypt13	msil
msilkrypt14	msil
msilkrypt15	msil
msilkrypt16	msil
msilkrypt17	msil
msilkrypt18	msil
macrooffice	msoffice
msoffice8	msoffice
office	msoffice
excel	msexcel
excel4	msexecl
word	msword
multios	multi
pdfjs	pdf
pdfview	pdf
malpe	pe
malpe1	pe
malpe10	pe
malpe11	pe
malpe16	pe
malpe17	pe
malpe19	pe
malpe2	pe
malpe20	pe
malpe21	pe
malpe22	pe
malpe23	pe
malpe24	pe
malpe25	pe
malpe26	pe
malpe29	pe
malpe3	pe
malpe30	pe
malpe31	pe
malpe32	pe
malpe33	pe
malpe34	pe
malpe35	pe
malpe36	pe
malpe37	pe
malpe3	pe
malpe4	pe
malpe5	pe
malpe6	pe
malpe7	pe
malpe8	pe
malpe9	pe
perl2	perl
virusperl	perl
phpshell	php
phpsmall	php
ps	powershell
psh	powershell
powsershell	powershell
pwrsh	powershell
py	python
pyc	python
ruby13	ruby
scriptsh	script
591591script	script
asscript	script
malscript	script
scr	script
script00	script
script2	script
scripts	script
scritp	script
sf	sfx
smbos	symbos
symb	symbos
symbos9	symbos
txt	text
unix7	unix
vb	vbs
vb2	vbs
vbcrypt	vbs
vbcryptb	vbs
vbgen	vbs
vbgeneric	vbs
vbgent	vbs
vbinf	vbs
vbkrypt	vbs
vbkrypt2	vbs
vbkrypt3	vbs
vbkrypt4	vbs
vbkrypt5	vbs
vbkrypt7	vbs
vbkrypt8	vbs
vbkrypta	vbs
vbkryptw	vbs
vbkryptx	vbs
vbobfus	vbs
vbobfuse	vbs
vbs2html	vbs
aw97m	w97m
mw97	w97m
w79m	w97m
wm97	w97m
w32	win32
wi32	win32
wiin32	win32
win31	win32
win32x	win32
winm32	win32
wni32	win32
wwin32	win32
w64	win64
winnt32	winnt
w95	win95
win9x	win95
excel97	x97m
mx97	x97m
xf	excelformula
xmldoc	xml

[PACK]
armadillo17	armadillo
armadillo3	armadillo
armadillo42	armadillo
armadillon	armadillo
aspack1	aspack
aspack212	aspack
enigmaprotector1	enigmaprotector
maskpet	maskpe
mfsg	fsg
mupx	upx
unknownupxmodifyer	upx
ntkrnl	ntkrnlpacker
mysticcompressor	mystic
npack1	npack
nsanti2	nsanti
nsantix	nsanti
nsantit	nsanti
nsantis	nsanti
nsantir	nsanti
nsantiq	nsanti
nsantip	nsanti
nsantim	nsanti
nsantil	nsanti
nsantik	nsanti
nsantih	nsanti
nsantihi	nsanti
nsantihj	nsanti
nsantihm	nsanti
nspack	nspack
nspack	nspack
nspack	nspack
nsis1	nsis
nspack1	nspack
nspack2	nspack
nspack3	nspack
nspackt	nspack
ntkrnlpa	ntkrnlpacker
ntkrnlp	ntkrnlpacker
ntkrnl0	ntkrnlpacker
ntkrnl	ntkrnlpacker
packman1	packman
pearmort	pearmor
pec1	pecompact
pespinv	pespin
pespinv0	pespin
pespinv1	pespin
petite1	petite
petite2	petite
rlpack1	rlpack
spack2	spack
spack3	spack
telock1	telock
themidaa	themida
upack0	upack
upack39	upack
vmppacker	vmprotect
vmprotect1	vmprotect
vmprotectt	vmprotect
yoda1	yoda
yodabased	yoda
yodacryptor	yoda
yodaprot	yoda
yodaprotector	yoda
yzpack1	yzpack
